R 2000 2000
NO ./textures/default_furnace_side.xpm
SO ./textures/default_furnace_side.xpm
WE ./textures/default_furnace_top.xpm
EA ./textures/default_furnace_top.xpm
S ./textures/boo.xpm
S2 ./textures/red_portal.xpm
C ./textures/night.xpm
F ./textures/desert.xpm

111111111111111111111111111111
1E0000000000011000000110000001
111111111111000011110110110101
100001200001111102010000112101
101101101100000001011121110101
101000001111011100000000000001
101111111111111111111112111111
100000020000000000002000000001
102000000000000200000000020001
111111111111111111111111111101
100000000000000000000000000001
111111111111111011111111111111
111111111111111311111111111111
111111111111111111111111111111
