R 1300 1300
NO ./textures/grass.xpm
SO ./textures/default_furnace_side.xpm
WE ./textures/default_furnace_top.xpm
EA ./textures/default_furnace_top.xpm
S ./textures/boo.xpm
S2 ./textures/heart.xpm
C ./textures/sky.xpm
F ./textures/desert.xpm

111111111111111111111111111111
1E0000000000011000000110000001
111111111111000011110110110101
100001200001111102010000112101
101101101100000001011121110101
101000001111011100000000000001
101111111111111111111112111111
100000020000000000002000000001
102000000000000200000000020001
111111111111111111111113111101
100000000000000000000000000001
101110111111101101101101101111
101000000030001111101100000021
101111111111111131121111111111
100000002000100000000000000001
110000200000100000001000020001
130000000200100000201000000021
112000010000002000001000000001
100002010000000000001020000001
101111111111111111111111111111
100000000000000000000000000001
101000111111111111111111111111
121110000000100011100020000001
101211110110001011101111011111
101000010111111011100000000011
100001000000000000001111111001
101111111111111111111111111101
100000000000000000000000000001
111111121111111001111111121111
100000000002000000000020000001
101111111111011111111011111101
100000000000000300000000000001
111111111111111111111111111111
